.............................[.......][......].............................
............................[....]..[.]..[....]............................
...........................[....]...[.]...[....]...........................
..........................[....]...[...]...[....]..........................
.........................[....]..[......]...[....].........................
........................[....]..[........]...[....]........................
.......................[....].....[....]......[....].......................
.....................[..............][...............].....................
.....................[..]..........[..]...........[..].....................
.....................[..]..........[..]...........[..].....................
.................[......]........[......].........[......].................
................[......]...........[..]............[......]................
...............[......]..........[......]...........[......]...............
..............[......].............[..]..............[......]..............
...............[......]..........[......]...........[......]...............
................[......]...........[..]............[......]................
